өрт==пожар
өртеу==поджигать
өріс==выгон, выпас, поле
өрлеу==подниматься, продвигаться
өрескел==грубый, вульгарный
өсу==расти, вырастать
өсіру==растить, выращивать
өскелең==плодовитый, быстрорастущий
өсиет==завет, заповедь
өту==переходить
өтірік==ложь
өтіп кету==пройти мимо, перейти
өтіну==пожалуйста
өтініш==просьба
өткір==смелый, бойкий, острый
өткізу==проводить (время), реализовывать
өткен жыл==прошедший год
өткен==прошедший, прошлый
өте-мөте==чрезмерно
өте==очень
өтек==утюг, гладить
өңшең==сплошь
өңкей==сплошь
өңдеу==ремонт, перерабатывать
өңделу==ремонтироваться, переделываться
өш==падкий, приверженный, месть
өшу==гаснуть, потухнуть
өшіру==выключать, заглушать
өшпенділік==ненависть
өкіру==рыдать, реветь
өкіл==представитель
өкіну==сожалеть, каяться
өкімет==власть
өкпелі==обиженный
өкпелеу==обижаться
өлтіру==убивать, лишать жизни
өлу==умиреть, скончаться
өлшеу==измерять
өлшем==размер
өлі==мёртвый
өлім==смерть
өзім==сам
өзімшіл==эгоистичный, эгоист
өзімшілдік==эгоизм
өзінше==по-своему
өзіндік==оригинальный, собственный
өлке==край, район
өзге==другой
өзгерту==менять
өзгеру==изменяться
өзгеріс==изменение, замена
өзгеше==особенный, особо, иначе
өлең==стих
өзді-өзі==друг с другом
өздік==возвратный
өздігінен==самостоятельно
өзекті==актуальный, основной, ключевой
өзен==река
өзара==между собой, взаимно
өзбек==узбекский, узбек
өн==вид, взгляд
өмір сүру==жить
өмір==жизнь
өмірлік==жизненный, пожизненный
өмірбаян==биография
өнім шығару==производить
өнім==продукт
өнімді==продуктивный, производительный
өнер==искусство
өнерлі==умелый, искусный, умелец
өндіру==производить, вырабатывать
өндіріс==завод
өндірістік==производственный
өйткені==потому что
өйнау==играть
өжет==настойчивый, упорный, смелый
әртүрлі==разный, разнообразный
әрі==дальше, туда
әріп==буква
әріптес==коллега, партнер
әрқашан==всегда, постоянно
әрлі-берлі==туда-сюда
әрең==едва, еле-еле
әрекет жасау==пытаться
әрекет==действия
әрекеттену==действовать, пытаться
әредік==изредка, редко
әрдайым==постоянно, систематически
әрбір==каждый
әсте==совершенно, совсем
әсіресе==особенно, особо
әскер==армия
әскери==военный
әсер ету==влиять
әсер==впечатление, влияние
әсерлі==впечатляющий, захватывающий
әсем==красивый, симпатичный, нарядный
әткір==острый
әткен==мимо, прошлый
әңгіме==беседа
әңгімелесу==собеседование, беседовать, общаться
әңгімелеу==рассказывать, повествовать
әңгiмешiл==разговорчивый
әуес==увлекающийся, любопытный
әуел==сначала
әуез==голос, мотив, напев
әуелі==сначала, даже
әуелгі==предыдущий, прежний
әуелде==в начале, прежде
әуен==мелодия
әуежай==аэропорт
әшекейлеу==влиять
әшейін==просто, просто так
әке==папа
әкету==забирать, уводить
әкелу==приносить
әл==сила, мощь
әлсіз==бедный, плохой, слабый
әлі кету==ослабевать, терять силы
әлі де==все еще
әлі==пока, ещё
әзір==готовый, пока, всё ещё
әзірше==пока, да
әзіргі==временный
әзірге==пока
әзірлік==подготовка
әзірлеу==приготовлять, готовить
әзірлену==готовиться, подготовиться
әзіл==юмор
әліпби==алфавит
әлгіде==недавно
әлпештеу==лелеять, нянчить
әзер==едва, кое-как, с трудом
әперу==подавать, доставать
әлеуметтік==социальный, общественный
әлем==мир
әлдеқашан==давно
әлдеқандай==какой-то, неизвестный
ән салу==петь
ән айту==петь
ән==песня
әнші==певец
әншейін==просто, бесплатно
әмір==властелин, приказание
әмбебап==универсальный, универсал
әйтеуір==в общем, всё же
әдіс==метод, прием, способ
әділ==справедливый, объективный
әйгілі==известный, знаменитый
әйнек==стекло, стакан
әйнектеу==стеклить
әже==бабушка
әдет==привычка
әдетте==обычно, как правило
әйел==женский
әйел==женщина
әдепті==вежливый, воспитанный, тактичный
әдемі==красивый
әдемілеу==украшать
әдейі==назло, специально
әдейілеп==специально
әдеби==литературный
әдебиет==литература
әбден==совсем, вполне
ұрсу==ругать, бранить
ұрсысу==ругаться
ұру==бить, ударять
ұры==вор
ұрыс салу==воевать, драться
ұрысу==ругаться, ссориться
ұрысқақ==скандальный
ұрлау==воровать
ұрпақ==потомок
ұран==клич
ұстату==держать
ұстау==держать
ұстаным==позиция
ұстамды==сдержанный
ұсыну==рекомендовать
ұсыныс==предложение
ұсқынсыз==некрасивый, неприятный
ұсақ==мелкий
ұсақтау==менять, размельчать, дробить
ұту==выигрывать
ұтып алу==выиграть
ұтылу==проиграться
ұтылып қалу==остаться в проигрыше
ұшу==полет, рейс
ұшыру==вспугнуть, запустить
ұшырау==попадать, подвергаться
ұшып шығу==вылететь
ұшып кету==улететь
ұшып келу==прилететь
ұшақ==самолет
ұя==гнездо
ұят==совесть, стыд
ұятсыз==бессовестный
ұялу==стесняться, стыдиться
ұялшақ==стеснительный, стыдливый
ұғу==понимать, вникать в суть
ұғым==смысл, суть, понятие
ұғымсыз==непонятливый, непонятно
ұғыну==понимать, осмысливать
ұғымды==понятливый, понятно
ұқсас==похожий, аналогичный
ұқсау==быть похожим
ұқыпты==аккуратный, бережливый
ұл==сын
ұлт==нация
ұлттық==национальный
ұлы==великий
ұлық==начальник, сановник
ұзын==высокий
ұзынша==продолговатый
ұзындық==длина
ұзарту==удлинять, продлевать
ұзау==отдаляться, отходить
ұзақ==долгий, дальний, долго
ұзамай==вскоре
ұн==мука
ұнтақ==порошок
ұмыту==забывать
ұмытып қалу==забыть, перестать помнить
ұмытылу==быть забытым, забываться
ұнату==одобрять, нравиться
ұнау==нравиться
ұйықтау==спать
ұйықтап кету==заснуть
ұйыкқтау==спать
ұжым==коллектив
ұйым==организация
ұйымдастыру==организовывать
ұйқы==сон
ұйқылы==сонный, заспанный
ұйқыдан тұру==подниматься, вставать после сна
ұйқасу==рифмоваться, быть созвучным
ұдайы==подряд, беспрерывно
рұқсат ету==позволять
рұқсат==разрешение
ру==род
рух==дух
рухани==духовный
риза==благодарный, довольный
республика==республика
республикалық==республиканский
ресми==официальный, официально
рет==ряд, порядок, повод
реттеу==регулировать, приспосабливать
реттiк==порядковый
рельс==рельс
ренжу (ренжі, ренжиді)==обижаться, сердиться
ренжіту==обижать
реакция==реакция
рас==правдивый, истинный, правда
раушан==роза
рахат==наслаждение
рахаттану==наслаждаться
разы==довольный, согласный
сөре==полка, витрина
сөз==слово
сөзуар==говорливый, говорун
сөзшең==разговорчивый, красноречивый
сөздік==словарь
сөну==потухать, гаснуть
сөмке==сумка
сөндіру==выключать
сөйту==делать так
сөйлесу==разговор, говорить
сөйлеу==говорить
сөйлем==предложение
сәрсенбi==среда
сәт==удача, везение, миг
сәтті==удачный, благоприятный, удачно
сәттілік==удача
сәуле==луч, свет
сәуiр==апрель
сәл-пәл==чуть-чуть
сәл==немного, слегка
сәлем==приветствие, привет
сәлемет==здоровый, невредимый
сәлемдесу==здороваться
сән==изящество
сәнді==модный, нарядный
сәндеу==украшать
сәйкестендіру==приводить в соответствие
сәйкесу==соответствовать
сұр==серый
сұрғылт==сероватый, бледноватый
сұрау салу==запрос, просить
сұрау==спрашивать
сұрақ==вопрос
сұраныс==спрос
сұңғақ==стройный, статный
сұхбат==беседа, диалог
сұхбаттасу==встречаться для беседы
сұлу==красивый, красавец, красавица
сұм==коварный, вероломный, плут, подлец
сұмырай==мерзкий, презренный
сұмдық==ужас, коварство
сұйық==жидкий, жидкость
сұйықтық==жидкий, жидкость
су==вода
сурет салу==рисовать
сурет==картина
суретті==иллюстрированный
суреттеу==изображать, описывать
суретке түсу==фотографироваться
сусын==напиток
суу==охлаждаться, остужаться
суыру==вынимать, выдергивать
суыту==охлаждать, остужать
суық тию==простудиться
суық==холод, холодный
сулы==мокрый
сулау==смачивать, увлажнять
судья==судья
суару (суғару)==поливать, орошать
сыр==секрет, тайна
сырт==внешность, внешняя сторона
сыртта==снаружи
сыртында==вне, снаружи
сыртынан==снаружи
сыртқы==наружный, внешний
сырғанау==кататься
сырқат==болезнь
сырқаттану==болеть
сырлы==таинственный, крашеный
сырлас==близкий, с кем делишься тайнами
сырлау==красить
сыра==пиво
сыю (сый, сыяды)==вмещаться, быть в пору
сығу (сық, сығады)==выжимать
сықылды==подобный, похожий, как будто
сызу==чертить
сыпыру==мести, подметать
сызық==линия
сыпайы==скромный, вежливый
сын==критика, испытание
сыну==сломаться
сыншы==критик, знаток
сыншыл==критикующий, склонный к критике
сынық==сломанный, разбитый, перелом, осколок
сынып==класс
сынған==сломанный
сындыру==разбивать, ломать
сындырып тастау==разбить
сынау==проверять, критиковать
сынақ==зачёт, испытание
сымбатты==стройный, статный
сый==подарок, уважение
сыйғызу==вмещать, помещать
сыйлық==подарок
сыйлау==дарить, уважать
сыйақы==премия
сүрту==протирать, тереться
сүртіну==вытираться
сүру==тесать, строгать
сүт==молоко
сүңгу (сүңгі, сүңгиді)==нырять
сүю (сүй, сүйеді)==любить, целовать
сүю==поцелуй
сүзу==бодать, цедить, фильтровать
сүйсіну==восхищаться, любоваться
сүйту==делать так
сүйікті==любимый, милый
сүйкімсіз==несимпатичный, неприятный
сүйкімді==симпатичный, приятный
сүйген==любимый
сүйеу==подпирать, поддерживать
сүйек==кость
сүйену==опираться
сіріңке==спичка
сіркіреу==моросить
сіңіру==усваивать, впитывать
сіңлі==младшая сестра (для женщины)
сіз==ты, вы
сілтеу==указывать, направлять
сілку==встряска, встряхивать
сілкіп қалу==встряска, встряхивать
сирек==редкий, редко
сиыр==корова
сиыну==молиться
сия==чернила
сияқтану==уподобляться
сипат==вид, облик, форма, черта
сипау==гладить, сглаживать
сипалау==поглаживать, массировать
сор==несчастье, беда
сорлы==бедный, несчастный, бедняга
сорпа==суп
сорақы==несуразный, нелепый
сосын==потом, затем
сот==суд
сотқар==драчливый, драчун, задира
соңы==конец
соңғы кезде==в последнее время
соңғы==последний
сою==колоть, резать, бить
соғу (соқ, соғады)==бить, ударять, дуть
соғыс==война
соғысу==воевать
соқтығу==столкнуться, удариться, нападать
соқыр==слепой, слепец
соққы==удар, ударить, разбиваться
соқа==плуг
сол үшін==для того
сол жақта==слева
сол жаққа==там, туда
сол==левый
солтүстік==север
созу==тянуть, протягивать
созылу==простираться, растягиваться
солға қарай==лево, левый
солға==налево
сопақ==овальный, продолговатый
солай==так
солайша==таким образом
сонша==столько, вот столько
соншалық==столько, вот столько
соншама==столько
соны==девственный, нетронутый, новый
сонымен==так
сонда==тогда
сомдау==создавать образ
сондағы==тогдашний
сондай==такой
сонағұрлым==более
содыр==озорной, драчливый, озорник
содан кейін==потом
серт==клятва
серуен==прогулка
серуендеу==гулять
серік==спутник, друг
сергек==бодрый, живой, бдительный
сескену==опасаться
секунд==секунда
секунда==секунда
секіру==прыгать
сезу==чувствовать, ощущать
сезім==чувство
сезімтал==чувствительный, сентиментальный
сезіну==ощущать
сену==верить, доверять
семіз==толстый, жир
сенім==вера, доверие
сенімді==уверенный, определенный
сенгіш==доверчивый
сенбi==суббота
сейсенбi==вторник
себу (сеп, себеді)==сеять, посыпать
себет==корзина
себеп==причина
себепсіз==без причины
сар==стремительный
сары май==масло
сары==жёлтый
сарын==мотив, напев
сарғыш==желтоватый
сараң==жадный, скупой, скряга
сарай==дворец
сасу (сас, сасады)==теряться, суетиться
сасу (сасы, сасиды)==вонять
сату==продавать
сатушы==продавец
сатып алу==покупать
сатылу==продаваться
сау адам==здоровый
сау==здоровый
саусақ==палец
саңырау==глухой
сауығу (сауық, сауығады)==выздоравливать
сауда==торговля
саудагер==торговец
сауатты==образованный, грамотный
сауал==вопрос
сауалнама==анкета
сахна==сцена
саяси==политический
саясат==политика
саяхат жасау==путешествовать, поездка
саяхат==путешествие
саяхаттау==путешествовать
саябақ==парк
сағыну==скучать
сағат==час, часы
сақ болу==быть осторожным
сақ==осторожный, бдительный, чуткий
сақтау==беречь, сохранять
сақал==борода
сақалды==бородатый
салт==обычай, обряд
салтанатты==торжественный, парадный, роскошный
салу==класть, строить
салыстыру==сравнение
салық==налог
салыну==строиться, воздвигаться
салқын==холодный
салқындау==охлаждаться
салмақ==вес, масса
салмақты==серьёзный
сапа==качество
сала==отрасль, сфера
сапар==путешествие
сапалы==качественный
сан алуан==различный
сан==число, счёт
сансыз==бесчисленный, несчётный
саны==количество
самғау==взмывать
сана==сознание, интеллект
санау==считать
саналу==считаться, числиться
саналы==сознательный
сай==подходящий, соответствующий, овраг, ложбина
сайлау==выбор
сабыр ету==терпеть, успокоиться
сабырсыз==неспокойный, нетерпеливый
сабырлы==спокойный, терпеливый
сабын==мыло, мылить
сабындау==намыливать
сабақ==урок
сабан==солома
төр==почётное место
төрлету==проходить на почётное место
төре==господин, аристократ
төс==грудь
төсеу==стелить, расстилать
төсек==кровать
төгу (төк, төгеді)==выливать, высыпать
төлеу==оплата
төлем жасау==производить оплату
төлем==платёж
төну==приближаться, нависать
төмен түсу==спускаться вниз
төмен==низкий, вниз
төменгі==нижний, нижеследующий
төменде==внизу
төмендеу==понижаться, падать
төбе==холм, потолок, верхняя часть
тәртіп==правило
тәріздену==быть похожим
тәрелке==тарелка
тәрбие==воспитание
тәрбиелеу==воспитывать
тәтті==сладкий
тәуір==дельный, приличный, прилично
тәңір==Всевышний
тәңірегінде==вокруг
тәулiк==сутки
тәуекел==риск
тәуелсіздік==независимость
тәуелсiз==независимый
тәуелді==зависимый
тәкаппар==высокомерный, надменный
тәжірибе жасау==испытывать
тәжірибе==опыт
тәжірибелі==опытный
тәбет==аппетит
тұру==стоять, находиться, проживать
тұрғызу==ставить, строить, воздвигать
тұрі==вид, тип
тұрмыс==быт
тұрмыстық==бытовой
тұрмысқа шыққан==замужем
тұрақты==постоянный, устойчивый, местный
тұс болу==попадаться
тұс==край, направление, момент
тұстас==параллельный, современник
тұту==держать, ловить
тұтқын==плен, заточение, пленник, узник
тұтас==сплошной, цельный, целиком
тұңғыш==первый, первоначальный, первенец
тұңғиық==глубокий, тёмный, мрачный
тұщы==пресный, несолёный
тұқым==порода, семя, потомство, род
тұз==соль
тұзды==солёный
тұздау==солить
тұздалған==солёный, засоленный
тұн==ночь
тұмсық==хобот, клюв
тұнық==прозрачный, чистый, ясный
тұмау тию==грипповать
тұмау==простуда, насморк, грипп
тұмаурату==простудиться, грипповать
тұман==туман
тұйық==замкнутый, скрытый, тупик
тура==прямой, справедливый
турау==разрезать, разрубать
турашыл==прямолинейный
туу==родить, рождаться
туыс==родственник, родич
туысқан==родной, родственник
туылу==рождение
туғызу==порождать, вызывать
туған күн==день рождения
туған жер==место рождения
туған==родной, рождённый
тудыру==рожать, зарождать
тырысу==попытка
тыс==верх, обложка, двор
тың==бодрый, крепкий, оригинальный
тыңдау==слушание, слушать
тыю==прекращать, запрещать
тығу==прятать, втыкать
тығыз==плотный, густой, срочный
тығылу==втыкаться, скрываться
тым==слишком
тыну==затихать, успокаиваться
тыныс алу==дышать, успокоиться, отдохнуть
тыныс==дыхание
тыныш==тихий, успокаивать
тыныштық==покой
тынымсыз==беспокойный, беспрерывный
тынымды==спокойный
түр==вид, форма
түрге бөлу==сортировать
түрлі түсті==разноцветный
түрлі==разный, различный
түрме==тюрьма
түс==цвет
түсті==цветный
түсте==в обед
түсу==спускаться, падать
түсіру==ронять, опускать
түсіріп алу==ронять, фиксировать, закачивать
түсіну==понимать
түсінік==понимание
түсініксіз==неясный, непонятный, непонятно
түсінікті==ясный, понятный, ясно, прямо
түсіндіру==объяснять, растолковывать
түскі==обеденный
түтін==дым
түңілу==терять надежду, отворачиваться
түшкіру==чихать
түшкірік==чихание
түю==толочь, растирать
түк==волос (на теле), пушок, щетина
түгел==полностью
түгелімен==полностью, целиком
түп==корень, дно, низ
түзу==прямой, ровный, правильный,
түлкі==лиса
түзету==корректировать, исправлять
түзеу==выправлять, исправлять
түзелу==исправляться
түн ортасы==полночь
түн==ночь
түнгі==ночной
түнеу==ночевать
түнде==ночью
түйілу==сводить, давиться
түйін==узел, смысл, суть
түйе==верблюд
түбіртек==квитанция
тіршілік ету==существовать, жить
тіршілік==жизнь, существование
тірі қалу==остаться в живых, выжить
тірі==живой
тірілу==оживать, воскресать
тірідей==живьем, заживо
тіркесу==сочетаться, сцепляться
тіркеу==записать, соединить,
тіркелу==регистрироваться
тірлік==жизнь, существование
тіс щеткасы==щетка
тіс==зуб
тістеу==укус
тік==прямой, резкий, прямо
тігу (тік, тігеді)==шить
тіке==прямой
тікелей==прямо, непосредственно
тіл==язык
тіпті==даже, очень
тілу==резать на куски
тізу==нанизывать, устанавливать в ряд
тізім==список
тізе==колено
тілеу==желать
тілеулес==сочувствующий, солидарный
тілек==желание
тілден қалу==лишиться речи
тию (ти, тиеді)==трогать, касаться, задевать
тиімді==оптимальный, выгодный, удобный
тиімділік==эффект
тигізу==прикосновение, касаться
тор==клетка, сетка
торы==гнедой
тосу==ждать
тосын сый==сюрприз
тосап==варенье
тоңу==мёрзнуть
тою (той, тояды)==насыщаться
тоғай==лес
тоқ==сытый, упитанный
тоқтату==задерживать, прекращать
тоқтау==останавливаться, переставать
тоқталу==останавливаться, прекращаться
тоқу==ткать, вязать
тоқыма==вязаный
токтау==останавливаться
топ==группа
толтыру==заполнять
тозу==изнашиваться, устаревать
толу==наполняться, полнеть
толы==полный, наполненный
топырақ==почва, земля
толық==полный
толықтыру==дополнение
толғану==обдумывать
толқу (толқы, толқиды)==волноваться, колыхаться
толқын==волна
толқынды==волнистый
топас==тупой
той==той, празднование
тойлау==праздновать
теру==собирать, подбирать
тері==ткань
теріс==неправильный, отрицательный
тергеу==расследовать
терлеу==потеть
терең==глубокий
терезе==окно
тербету==качать, убаюкивать
тесу==продырявливать
тең==равный
теңіз==море
теңгерім==баланс
теңестіру==уравновешивать
тек==только
тексеру==проверять
текті==плодородный
тегіс==гладкий, мягкий, плоский, приглаживать
тегін==бесплатный, бесплатно
тегінде==точь-в-точь, в самый раз
текке==зря, понапрасну
тегiстеу==выравнивать, шлифовать
тез==быстро, скоро
тезірек==быстрее, скорее
телефон соғу==звонить
телефон шалу==звонить
теория==теория
тентек==избалованный, озорной, озорник
темір==железный, железо
темекі шегу==курить
тежеуіш==тормоз
театр==театр
тебу (теп, тебеді)==кататься, пинать
тар==узкий, тесный
тарту==играть (на инструменте), курить
тартыс==борьба, схватка, конфликт
тартып алу==отобрать, отвоевать
тартымды==обаятельный, симпатичный
тарқау==расходиться
тарих==история
тарихи==исторический
тарату==распространять, раздавать
тарау==расчесывать
таразы==весы
тарану==расчёсываться
тас==камень
тасты==каменистый
тастау==бросать, кидать
тастап шығу==бросить
тасу (тасы, тасиды)==выходить из берегов, ликовать
тасу==везти
тату==отведывать, испытывать
татып көру==пробовать на вкус
таң==утро
тау==гора
таңу==завязывать, обматывать
тауып алу==найти
таңғы==утренний, завтрашний
таулы==горный
таңертең==утром
таңертеңгі==утренний
таңдау==выбирать
таңдаулы==отборный, избранный, элитный
таңдану==удивляться, восхищаться
таңба==клеймо, метка, знак
таяу==ближайший, близко
таяз==мелкий, неглубокий
тағу (тақ, тағады)==прицеплять, прикалывать
тағы да==еще, даже
тағы==нелюдимый, дикий
тағдыр==судьба
тағам==еда
тақ==отдельный, нечётный
тақта==доска
тақырып==тема
тақау==приближать, придвигать вплотную
тап==класс, сословие, пятно, след
тапсыру==сдавать
тапсырыс беру==заказать
тапсырыс==заказ
тапсырма==задание
таптық==классовый
талу==терять сознание, неметь
талғау==отбирать, выбирать
талғаулы==отборный, избранный
талғам==вкус
тапқыр==находчивый, остроумный
талқылау==обсуждение
талқандау==громить, разрушить
талдау==анализировать
таза==чистый
тазарту==чистить
тазару==очищаться, избавляться
талас==спор
таласу==спорить, бороться
талап ету==требовать
талап==условие
талапты==целеустремленный, инициативный
тазалау==уборка, убирать
талай-талай==неоднократно, много раз
талай==значительно, немало
тану (тан, танады)==отказываться, отрекаться
тану (таны, таниды)==познавать, признавать
тамшы==капля, опускать
тамшылау==капать, течь каплями
тамыр==корень
таныс==знакомый
таныстыру==знакомить
танысу==знакомиться
танысып қою==познакомиться
таныту==учить
тамыз==август
тамызу==капать лекарство
танылу==быть опознанным
тамаша==замечательный, великолепный
тамашалау==развлекаться, любоваться
тамақ ішу==кушать
тамақ беру==кормить
тамақ==еда
тамақтану==кушать, питаться
тайғанау==скользить
табу (тап, табады)==находить, обнаруживать
табыс әкелу==получать прибыль
табыс==прибыль
табысу==сойтись, найти друг друга
табылу==найтись, обнаружиться
табиғи==натуральный
табиғат==природа
табанды==настойчивый, упорный
у==яд
уәде==обещание
уу==яд, отравлять
улы==ядовитый, едкий
улау==яд, отравлять
уақыт өткен сайын==с течением времени
уақыт белгілеу==назначить время
уақыт==время
уақытша==временно
уақытында==вовремя
уайымдау==беспокоиться, грустить
физикалық==физический
форма==форма
ферма==ферма
химикат==химикат
хат==письмо
хатшы==секретарь
хал==дела, положение
халық==народ
халықтық==народный
халықаралық==международный
хан==хан
хабар салу==оповещать
хабар ету==сообщать, известить
хабар==сообщение
хабарлы==знающий, осведомлённый
хабарласу==обмениваться вестями
хабарлау==сообщить
хабарландыру==объявление
шөп==трава
шөл==пустыня
шөлдеу==испытывать жажду, хотеть пить
шәкірт==ученик, последователь
шұғыл==быстро, поспешно
шұғылдану==заниматься
шұқу (шұқы, шұқиды)==ковырять, клевать
шұбар==пятнистый, рябой
шу==шум
шулау==шуметь
шырша==ёлка
шырылдау==пищать, звенеть
шырын==сок
шырқау==громко петь, прогрессировать
шырақ==свеча, светильник
шың==вершина
шығу (шық, шығады)==выходить, появляться
шығу==выходить
шығыс==восток
шығару==выводить, увольнять, издавать
шығарып салу==провожать
шығарма==сочинение, произведение
шын==истинный, настоящий, правда
шыншыл==правдивый, искренний
шынығу (шынық, шынығады)==закаляться, тренироваться
шымылдық==занавес
шындық==правда, правдивый
шынаяқ==чашка
шынайы==истинный, искренний
шыдау==терпеть, переносить
шыдам==терпение
шыбық==прут
шыбын==муха
шіркеу==церковь
ширақ==живой, бодрый, живо, бодро
шикі==сырой, неспелый
шипажай==санаторий
шошу (шошы, шошиды)==пугаться, восполяться
шошқа==свинья
шоқ==букет
шолу==обозревать, осматривать
шолақ==короткий, недалекий
шомылу==купаться
шомылдыру==купать
шерту==щёлкать, играть на домбре
шерлі==печальный, убитый горем
шет==край, окраина, сторона
шеткі==крайний, отдаленный
шетелдік==зарубежный, иностранный
шешу==развязывать, решать
шешілу==развязываться, решаться
шешім шығару==выносить решение
шешім==решение
шешіну==раздеваться
шеше==мама
шексіз==бесконечный, бескрайний
шектесу==граничить
шектеу==ограничивать
шегу (шек, шегеді)==курить, испытывать
шегіну==отступать
шегелеу==прибивать гвоздями
шелек==ведро
шебер==мастер
шеберлік==мастерство
шарт==условие
шаруа==дело
шаруашылық==хозяйство
шаршы==квадратный, квадрат
шаршау==утомляться, уставать
шаршанқы==усталый
шара==мера, средство
шарасыздан==безысходно
шарап==вино
шатыр==крыша
шаң сору==пылесосить
шаң==пыль
шаш үлгісі==причёска
шаш==волосы
шашты==волосатый
шашу==брызгать, рассыпать
шағу==колоть, дробить, кусать
шағын==небольшой, малый
шақ==время, период
шақырту==звать, приглашать
шақыру==вызов, приглашение
шал==старик
шалу==задевать, уловить
шапшаң==быстрый, быстро
шалғай==самый дальний
шалқасынан==навзничь
шала==половинчатый, наполовину
шам==лампа
шанышқы==вилка
шанды тазалау==чистить
шанжыр==цепь
шама==мера, размер, сила, мощь
шамалы==ограниченный, примерно, около
шай==чай
шайқау==раскачивать, трясти
шайнау==жевать
шабу (шап, шабады)==скакать, косить, рубить
шабуыл==нападение, нападать
шабыт==вдохновение
шабытты==вдохновенный, вдохновенно
шiлде==июль
ырғу (ырғы, ырғиды)==спрыгивать, вскочить
ырза==довольный, согласный
ыстық==горячий, жаркий, горячо, жарко
ыңғайсыз==неудобный, неподходящий
ыңғайлы==комфортный, удобный, удобно
ықылас==желание
ықпал==влияние, воздействие
ылғи==постоянно
ылғал==влажный
ылғалды==влажный
ыза==гнев, досада
ызақор==злой, гневный
ызалы==агрессивный, разъярённый
ынтымақ==согласие, единодушие
ынтымақтастық==сотрудничество
ынта-ықылас==желание, усердие
үру==дуть, лаять
үрку==пугаться
үрлеу==дуть, надувать
үрдіс==тенденция
үрей==бояться, страх
үсті-үстіне==вновь и вновь
үсті==верхняя часть, поверхность
үстінде==на
үстеу==прибавлять, досыпать
үстел==стол
үстелу==быть добавленным
үстем==господствующий, доминирующий,
үтік==утюг
үтіктеу==гладить
үңілу==всматриваться
үшін==для
үшбұрышты==треугольный
үкімет==правительство
үзу==обрывать, прерывать
үзілу==обрываться, прерываться
үзіліс==перемена, антракт
үлгі==пример, образец
үлгілі==образцовый, показательный,
үлгеру==успевать
үлкен==большой
үздік==лучший, передовой, выдающийся
үздіксіз==непрерывно
үн==голос, звук
үнсіз==безмолвный, беззвучный, безмолвно
үміт ету==надеяться, возлагать надежду
үміт==надежда
үміттену==надеяться
үнемі==постоянно
үнемдеу==экономить
үндеу==звучать, подавать голос
үндемеу==молчать, безмолвствовать
үй салу==строить дом
үй шаруасы==домашние дела
үй құсы==домашняя птица
үй==дом
үйрету==учить, обучать
үйрену==учиться, привыкать
үйреншікті==привычный, обыденный, хронический
үйлесу==сходиться, гармонировать
үйлесім==гармония
үйлену==жениться
үйленген==женатый
ғылым==наука
ғылыми==научный, учёный
ғимарат==здание
ғасыр==век, столетие
ғашық==влюбленный человек
ғапу==прощение, извинение
ғалым==учёный
ғаламтор==интернет
ғанибет==наслаждение, удовольствие
ғажап==дивный, прекрасный
ғажайып==удивительный, чудесный, сказочный
ірі==крупный, грандиозный
іріктеу==сортировать
ірімшік==сыр
ірку==задерживать, тормозить
іркілу==набегать, скапливаться
ірмішік==сыр
іс==дело
іссапар==командировка
істеу==выполнять, действовать
істелу==быть сделанным
істен шығу==ломаться, выходить из строя
іске асыру==осуществлять, проводить в жизнь
іскер==деловой, дельный, толковый
іш==внутренняя часть, нутро, живот
ішу==пить
ішінде==в
ішкі==внутренний
із==след
ілу==вешать, зацепить
ілулі==подвешенный, навешанный
іліп кету==своровать
іліну==зацепиться, повиснуть
ілмешек==крюк
ілесу==следовать, идти следом
іздеу==искать, разыскивать
іздену==разыскивать, хлопотать
іні==младший брат
құр босқа==напрасно
құр==зря
құрту==уничтожать
құру (құр, құрады)==строить, воздвигать
құру (құры, құриды)==вымирать, пропадать
құрылу==строиться, воздвигаться
құрылыс==стройка
құрылым==структура
құрғақ==сухой, высохший, суша
құрмет==уважение
құрметті==уважаемый, почётный
құрметтеу==уважать
құрмалас==сложный, примыкающий
құрау==составлять, собирать, копить
құрал==инструмент
құралу==составляться, копиться
құрама==сборный, составной, комбинированный
құс==птица
құтты==счастливый, удачливый, благодатный
құттықтау==поздравлять
құтыру==неистовствовать
құтылу==избавляться, спасаться
құтқару==спасать, выручать
құтқарып қалу==спасти, выручить
құштар==влюбленный, увлеченный, страстный
құшақтасу==обниматься
құшақтау==обнимать
құю (құй, құяды)==лить, наливать
құл==раб, невольник
құптау==поддерживать, одобрять
құзіреті==полномочие
құпия==секретный
құла==саврасый, сухой, голый, плоский
құлау==песок
құлақ==ухо
құм==песок
құнсыз==бесценный, неоценимый
құндылық==ценность, оценивать
құйрық==хвост
құдық==колодец
құйып шығу==пролить
құжат==документ
құдай==бог
құбыр==труба
құба==светло-жёлтый, светловолосый
қу==хитрый, лукавый, хитрец
қуу==гнать, прогонять
қуыру==жарить
қуырылу==жариться
қуырылған==жаренный
қулып==замок
қулақ==ухо
қумырсқа==муравей
қуат==мощь, сила, энергия
қуатты==сильный, мощный, калорийный
қуану==радоваться, ликовать
қуаныш==радость
қуанышты==радостный, восторженный
қыр==горный хребет, ребро, грань
қырсық==упрямый, несговорчивый
қыру==брить, скоблить
қыруар==много, множество
қырыну==бриться
қырғыз==киргизский, киргиз
қыркүйек==сентябрь
қырлы==гранёный, гранный
қыс==зима
қыстау==зимовать
қысу==жать, прижимать
қысы-жазы==зимой и летом
қысылу==стесняться, быть зажатым
қысым==давление
қысқы==зимний
қысқа==короткий
қысқарту==сокращать, укорачивать
қысқару==сокращаться, укорачиваться
қысқаша==кратко
қыңыр==капризный, упрямый
қышқыл==кислый, кислота
қыз==дочь, девочка
қылу==делать, совершать действие
қызу==активный, жаркий
қызулы==горячий
қызығу (қызық, қызығады)==интересоваться, увлекаться
қызығу==интерес
қызығушылық==интерес, увлеченность
қызық==интересный, занимательный
қызықсыз==неинтересный
қызықты==интересный, интересно
қызықтыру==заинтересовывать
қызыл==красный
қызғылт сары==оранжевый
қызғылт==розовый
қызғану==ревновать, оберегать
қызғаншақ==ревнивый
қылмыс==преступление
қызмет көрсету==обслуживать
қызмет ету==служить
қызмет==должность, работа, служба
қызметкер==сотрудник, служащий
қызару==краснеть
қызба==горячий, вспыльчивый
қымсыну==стесняться, смущаться
қымыз==кумыс
қымбат==дорогой
қымбатты==уважаемый, дорогой, ценный
қыдырту==выгуливать, сопровождать
қыдыру==гулять
қисық==кривая
қиылысу==пересекаться
қиын==трудный, тяжёлый, тяжело
қию (қи, қияды)==резать, срезать
қиял-ғажайып==волшебный, фантастический
қиял==фантазия
қимыл==действие, движение
қинау==мучить, истязать
қиналу==мучиться, затрудняться
қор==униженный, оскорбленный
қоршау==огораживать, окружать
қорыту==подытоживать, обобщать
қорытынды==итог
қорғау==охранять, защищать
қорғалыну==охраняться
қорқу (қорық, қорқады)==бояться, пугаться
қорқу==бояться, страх
қорқыту==пугать, устрашать
қорқақ==трусливый, боязливый, трус
қорлық==издевательство
қора==хлев
қорап==ящик
қос==парный, двойной
қостау==одобрять, поддерживать
қосу==включать, добавлять
қосылу==присоединяться
қосымша==дополнительный, дополнение
қоңыр==коричневый
қоңырқай==дымчато-серый, заурядный, простой
қоңырау соғу==звонитьI
қоңырау шалу==звонитьV
қоңырау==колокольчик
қош==отличный, прекрасный, отлично
қоштасу==прощаться
қнын==трудный
қою (қой, қояды)==класть, ставить
қою==густой, гуща
қоян==заяц
қоғам==общество
қоғамдық==публичный
қоқыс==мусор
қол тию==иметь время
қол қою==подписывать
қол жету==достигать
қол беру==подавать руку, помогать
қол==рука
қолшатыр==зонт
қозы==ягненок
қозғау==двигать, шевелить
қолғап==перчатка
қозғалту==расшевеливать
қозғалыс==движение
қолма-қол==собственноручно
қолдау==одобрять, поддерживать
қолдан келу==мочь
қолдану==использование, использовать
қолданылу==использоваться, применяться
қола==бронзовый, бронза
қолайлы==удобный, подходящий
қону==приземляться, спускаться
қоныр түс==коричневый
қоныс==стоянка, стойбище
қонымды==доступный, приятный
қонақ ету==угощать, принимать гостя
қонақ==гость
қонақжай==гостеприимный
қой==баран, овца
қойшы==чабан
қойылу==ставиться, сгущаться
қобалжу (қобалжы, қобалжиды)==волноваться, беспокоиться
қар==снег
қарсы шығу==выступить против
қарсы алу==встретить
қарсы болу==возражать
қарсы==против
қарсы==напротив, противоположный
қарсылық==возражение, несогласие
қарсаңында==накануне
қарт==старый, старец
қартаң==пожилой, престарелый
қартаю (қартай, қартаяды)==стареть
қару==оружие
қарулы==вооруженный, сильный
қарыз==долг
қарын==живот, желудок
қарындаш==карандаш
қарлы==снежный
қарны ашу==проголодаться
қара==чёрный
қарастыру==изыскивать, рассматривать
қарасу==переглядываться
қараторы==смуглый
қарау==смотреть, глядеть
қараңғы==тёмный, темнота, темно
қараңғылық==темнота
қараңғалық==темнота, темный
қараша==ноябрь
қараю==темнеть, чернеть
қарап шығу==просмотреть
қараптан-қарап==вдруг, ни с того, ни с сего
қаралу==проходить осмотр
қарапайым==простой
қас==враждебный, враг
қасық==ложка
қасында==рядом, около
қасқыр==волк
қасқа==лысый, несчастный
қасиет==качество, особенность
қасиетті==благородный, священный
қасақана==нарочно
қатты==жёсткий, твёрдый
қату==замерзать, леденеть, твердеть
қатыру==замораживать
қатысу==принимать участие
қатын==замужная женщина, жена
қатігез==жестокий
қатқыл==твердый, жестокий, строгий
қате жіберу==допускать ошибку
қате==ошибка
қателік==ошибка
қателесу==ошибаться
қатар==рядом, наряду
қатаң==жестокий, строгий, жестко, строго
қатал==жестокий, строгий, суровый
қаңтар==январь
қауырсын==перо
қауырт==спешно
қауым==общество, среда
қауіп-қатер==опасность
қауіпсіз==безопасный
қауіпсіздік==безопасность
қауiпсiз==безопасный, безопасно
қауiптi==опасный, рискованный
қашу==убегать
қашық==далёкий, отдаленный, далеко
қашып шығу==выбежать
қашан==когда
қаяақ==лодка, судно
қағу (қақ, қағады)==выбивать, вытряхивать
қағаз==бумага
қақ==прямо, ровно
қал-жағдай==дела-обстоятельства
қал==состояние, дело, родинка
қап==мешок
қалта==карман
қаптау==обшивать, обёртывать
қаптама==покрытие
қазу==копать, рыть
қалу==оставаться
қалың==густой, частый, толстый
қалып==состояние, положение
қалыпты==нормальный
қазына==богатство, капитал, клад
қазір ғана==только что
қазір==сейчас
қазіргі==данный, современный, текущий
қазірде==сейчас, в настоящий момент
қалпына келтіру==восстановление, восстанавливать
қалпақ==шляпа
қалдыру==оставлять
қаза==смерть, кончина
қала==город
қалау==желать, возводить
қазақ==казахский, казах
қазақша==по-казахски
қалалық==городской
қалам==ручка
қазан==октябрь
қалану==возводиться, создаваться
қалай==как
қазiр==сейчас
қан қысымы==давление
қан==кровь
қам==забота
қант==сахар
қамтамасыз==обеспеченный
қану==напиваться, утолять жажду,
қамшы==кнут, плеть
қамыр==тесто
қамқор==заботливый, участливый
қамқорлық==забота
қанды==кровавый
қанат==крыло
қамау==окружать, осаждать, загонять
қанағаттану==удовлетворяться, быть довольным
қайрат==сила, мощь
қайратты==волевой, бесстрашный
қайраткер==деятель
қайсар==волевой, стойкий, упорный
қайту==возвращаться
қайтып келу==вернуться
қайтып алу==взять обратно
қайта-қайта==снова и снова
қайта сұрау==переспрашивать
қайта==опять, снова, повторно
қайтару==возвращать
қайталау==повторять
қайталану==повторяться
қайтадан==снова, повторно
қажу (қажы, қажиды)==утомляться, слабеть
қайшы==ножницы
қайыру==возвращать, давать сдачу
қайырымды==добрый
қажырлы==упорный, энергичный, смелый
қайырлы==добрый, благополучный
қайық==лодка
қайғы==горе
қайғылы==печальный, скорбный
қайнату==кипение
қайнау==кипеть
қайнаған==кипячёный
қаймақ==сметана
қажет==нужда, необходимость
қажеттілік==потребность, необходимый
қажеттi==нужный, необходимый
қайда==где, куда
қайдан==откуда
қадау==втыкать, прикалывать, пришивать
қадалу==втыкаться, вонзаться
қадам==шаг, шагать
қадiрлi==уважаемый, авторитетный, ценный
қабу (қап, қабады)==стегать, кусать
қабылдау==принимать, одобрять
қабат==этаж
қабақ==веко, настроение
қаhарман==отважный, героический, герой
көр тышқан==крыса
көр==вид
көрсету==показывать
көрсетілу==показываться, проявляться
көру==видеть
көрші==сосед
көршілес==соседний, соседствующий
көрісу==видеться с кем-либо
көрікті==красивый (внешне), миловидный
көріну==показываться, виднеться
көрініс==вид, облик
көркем==красивый, художественный
көрме==выставка
көрнекті==видный, солидный
көтеру==поднимать
көтеріңкі==приподнятый, повышенный
көтерілу==подниматься
көңіл-күй==настроение
көңіл қалу==разочароваться, быть в обиде
көңіл көтеру==ободрять, поднимать настроение
көңіл==настроение, душа
көңілсіз==расстроенный
көңілді==весёлый, радостный, оживлённый
көңілдену==развеселиться, повеселеть
көшу==переезжать
көшіру==списывать, переселять
көшірме==копия
көшпелі==кочевой, передвижной
көше==улица
көшбасшылық==лидерство
көк==синий, природно-зеленый
көктем==весна
көктемгі==весенний
көкшіл==голубоватый, лазурный
көгілдір==голубой
көгеру==цвести, зеленеть
көкжиек==горизонт
көз жеткізу==убеждаться
көз==глаз
көл==озеро
көп==много
көптеу==делать сообща
көптеген==много, во множестве
көптен==давно
көпшіл==общительный
көпшілік==большинство, общество
көпір==мост
көлік жүргізу==вождение
көлік==машина, транспорт
көлікпен тасымалдау==транспортировать
көзінше==на глазах, в присутствии
көлеңке==тень
көлем==объём
көлемін анықтау==измерять масштаб
көлемді==объемный
көздеу==стремиться, целиться
көлденең==поперечный, неожиданный
көну==соглашаться, слушаться
көмір==уголь
көне==древний, старый, поношенный
көмескі==тусклый, нечеткий
көндіру==уговорить
көмек==помощь
көмектесу==помогать
көйлек==платье
көбінше==чаще всего, зачастую
көбінесе==чаще всего, зачастую
көбею (көбей, көбейеді)==размножаться, увеличиваться
көбейту==увеличивать, множить
кәрі==старый
кәрлі==яростный, свирепый
кәсіп==бизнес
кәдімгі==обыкновенный, настоящий, подлинный
краска==краска, рисовать, красить
куәлік==удостоверение, свидетельство
күрсіну==вздыхать
күріш==рис
күркіреу==греметь, грохотать
күрес==борьба
күресу==бороться
күрең==бурый, мрачный
күрделі==сложный, капитальный
күту==ожидание
күтіп баптау==выращивать
күтілу==ожидаться, быть ожидаемым
күткен==желанный
күтпеген==неожиданный
күңірену==омрачаться, мрачнеть
күңгірт==тёмный, неясный, тусклый
күш==сила, власть
күшті==сильный
күшею (күшей, күшейеді)==усиливаться, крепчать
күшейту==усиливать, укреплять
күю (күй, күйеді)==обжигаться, пригорать
гүл==цветок
күз==осень
күлу==смеяться, смех
күлісу==смеяться вместе
күлімдеу==улыбаться
күлкі==смех, улыбка
күлкілі==смешной, шуточный, весёлый
күлгін==фиолетовый
күлдіру==смешить
күлдіргі==смешной, потешный, комический
күн сайын==каждый день
күн күркіреу==гром
күн==день
күмән==сомнение
күні-түні==днём и ночью
күміс==серебро
күндіз-түні==днем и ночью, беспрерывно
күндіз==днём
күндізгі==дневной
күнде==каждый день
күндегі==каждодневный, повседневный
күнделікті==повседневный, обычный
күндiз==днём
күнi бойы==весь день, в течение дня
күй==кюй, мелодия, состояное
күдік==сомнение, подозрение
күйік==ожог
күдікті==сомнительный, подозреваемый
күйлі==зажиточный, упитанный, мелодичный
күйеу==муж, супруг
күйеуге шығу==выйти замуж
күйеуге шыққан==замужняя
кір жуу==стирать бельё
кір==грязь
кіру==входить
кірісу==вмешиваться, приступать
кіріп шығу==навестить, проведать
кіргізу==пропускать, вводить
кірпіш==кирпич
кірме==заимствованный
кісі==человек, личность
кітап==книга
кітапхана==библиотека
кіші==младший, малый
кішіпейіл==скромный, учтивый
кішкентай==маленький
кішкене==маленький, небольшой, немного
кілт==ключ
кілттеу==запирать на ключ
кім==кто
кінә==вина
кінәлі==виноватый, виновный
кінәлау==винить, обвинять
кідіру==задерживаться, приостанавливаться
кию (ки, киеді)==надевать
киіп алу==надеть
киім==одежда
киіну==одеваться
киіндіру==одевать, надевать
кигізу==надеть, заставить одеть
киноға түсу==сниматься в кино
классикалық==классический
корей==корейский, кореец
комитет==комитет
компания==компания
кер==заносчивый, строптивый
кертартпа==консервативный, отсталый
кері==назад
керек ету==иметь нужду
керексіз==ненужный, ненадобный
керекті==нужный, необходимый
керемет==великий, великолепный
кесте==расписание
кесу==резать
кесіп өту==пересечь
кесек==большой кусок, комок
кету==уходить, уезжать
кетісу==вместе расходиться
кең==широкий, просторный, свободный
кеңсе==офис
кеңістік==пространство
кеңінен==вширь, широко
кеңес беру==консультировать, давать совет
кеңес==совет
кеңесу==советоваться
кеуде==грудь, бюст
кеңейту==расширение
кеш==поздно
кешу==прощать
кешіру==прощать, переживать, испытывать
кешірім==прощение
кешірек==позднее, попозже
кешігу (кешік, кешігеді)==опаздывать, задерживаться
кешігу==опаздывать
кешігіп қалу==опоздать
кешқұрым==вечером
кешкі==вечерний
кешке==вечером
кеше==вчера
кешегі==вчерашний, былой
кешен==комплекс
кек==месть, злоба
кекшіл==злопамятный, мстительный
кекету==иронизировать, насмехаться
кез келген==любой
кез болу==повстречать
кез==время, пора, момент
кептіру==сушить
келтіру==приводить, доставлять
кептеліс==пробка (скопление)
келу==приходить
кезу==бродить, странствовать
келіссөз==переговоры
келісті==соответствующий, подходящий, приятный, красивый
келісу==договариваться, приезжать
келісім шарт==контракт
келісім==соглашение
келіп-кету==захаживать, бывать
кепілдік==гарантированный, гарантия
келін==невестка
кезінде==в своё время
келер жыл==будущий год
келесі==следующий
кезең==период
келешек==будущее
кезек-кезек==поочередно
кезек==очередь
кезектесу==чередоваться
келелі==кардинальный, узловой
кездестіру==встречать
кездесу==встреча
келбет==внешность
келбетсiз==некрасивый, невзрачный
келбеттi==красивый, представительный, статный
кем==плохой, слабый, меньше, хуже
кему==уменьшаться, ослабевать
кемшілік==недостаток
кемпір==бабка, старуха
кеме==корабль
кенет==внезапно
кенеттен==вдруг, внезапно
кемел==зрелый, достигший совершенства
кейін==после
кейінгі==следующий, последний
кедергі жасау==мешать, препятствовать
кейде==иногда
кедей==бедный, скудный, бедняк
кейбір==некоторый
кебу (кеп, кебеді)==сушиться, высыхать
картоп==картофель
карта==карта
кашу==бег, бегать
газет==газета
газдалған==газированный
камера==камера
кiбiсе жыл==високосный год
иә==да
пәтер==квартира
зәулiм==высотный, высокий, громадный
пәлте==пальто
ләззат==удовольствие
пәле==ложное обвинение, неприятность
проза==проза
ит==собака
итеру==толкать, передвигать
пысық==шустрый, расторопный
пышақ==нож
иық==плечо
иіс шығу==пахнуть
иіс==запах
пісу==вариться, печься
пісіру==готовить, варить
пісірілген==отварной
пішін==форма, вид, фигура
пікір==мнение
пікірін айту==высказывать
игі==хороший, чистосердечный, благой
игілік==доброе дело
игеру==овладевать, осваивать, справляться
икемі==склонность, сгибать
зиялы==интеллигентный, образованный
зиянды==вредный, вредоносный
изеу==кивать
зор==крупный, огромный
зорға==с трудом, еле-еле
зорлық==насилие, принуждение
институт==институт
ине==игла
пойыз==поезд
ие болу==владеть, быть хозяином
ие==хозяин, владелец
зерттеу==изучение
зерігу (зерік, зерігеді)==скучать, томиться
перде==занавес
иесі==владелец
иесіз==бесхозный, ничейный
иек==подбородок
лезде==мгновенно, вмиг, сразу
зейін==внимание
зейінді==внимательный, сообразительный
зар==скорбь, страдание, нужда
парыз==долг
зарлы==печальный, заунывный
парасатты==здравомыслящий, разумный
параллельді==параллельный
лас==грязный
зат==вещь, предмет
патша==властелин, царь
патшалық==царство
заң==закон
заңғар==громадный, высочайший
заңгер==юрист
заңды==законный, закономерный
лауазым==должность
лақтыру==кидать, бросать
зақым==повреждение
пакет==пакет
залым==вероломный, коварный, злой
занды==законный
панасыз==беспризорный, беззащитный
заман==эпоха, эра
лажсыз==безвыходно
лажсыздан==вынужденно
лайық==приемлемый, подходящий, достойный
лайықты==подобающий, должный, достойный
пайыз==процент
пайда болу==появляться, возникать
пайда==польза, выгода
пайдалы==полезный, выгодный, полезно
пайдалану==пользоваться
мөр==печать
мөлдір==чистый, прозрачный
нөмір==номер
нәрсе==вещь, предмет
нәрлі==питательный, сытный
нәресте==ребенок
мәселе==проблема, вопрос
нәтиже==результат
мәңгі==вечно
мәз==радостный, довольный
мәзір==меню
нәзік==тонкий, нежный, утончённый
мәлім==известный
мән==смысл, суть
мәжіліс==совещание
мәдени==культурный
мәдениет==культура
мәдениетті==культурный
мәжбүр==вынужденный, вынужденно
мәжбүрлеу==заставлять
нұр==луч
мұртты==усатый
мұрын==нос
нұрлы==светлый, лучистый
мұра==наследие
мұрагер==наследник
нұсқа==версия, набросок
нұсқау==сигнализировать, указывать
мұң==печаль, тоска
мұңлы==печальный, грустный
мұңды==печальный, грустный, горестный
мұхит==океан
мұғалім==учитель
мұз==лёд
мұнша==столько
мұнда==сюда, здесь
мұндағы==здешний
мұндай==такой, таковой
орта тұс==средний, середина
орта==средний, середина, среда
ортасы==средний, середина
ортасында==среди
орташа==средний, посредственно
ортақ==общий, совместный
орталық==центральный, центр
ору==косить
орыс==русский
орысша==по-русски
орын==место
орынсыз==неуместный, неуместно
орынды==местный, уместный, уместно
орындық==сиденье, место
орындау==выполнять, исполнять
орындалу==быть выполненным
орнығу (орнық, орнығады)==укрепляться, обосновываться, оседать
орнату==воздвигать, строить
орнау==быть воздвигнутым,
орналастыру==помещать
орналасу==располагаться
орман==лес
орасан==очень
орау==завёртывать
оралу==возвращаться, запутаться
орамды==проворный, оперативный
орамал==платок, полотенце
орай==возможность
осы туралы==о
осылай==так, таким образом
осылайша==так, таким образом
осынша==столько
осыншалық==столько
осында==здесь, сюда
осындай==такой
осал==слабый, некрепкий, слабо
от==огонь
отты==огненный, пламенный
отыру==сидеть
ота==операция (хирургическая)
отан==родина
отбасы==семья
оң жақта==справа
оң==правый
оңтүстік==юг
оңға==направо
музыка==музыка
оңаша==уединенный, отдельно
оңалу==улучшаться, выздоравливать
оңай==лёгкий, несложный, легко
мырза==щедрый, господин
мыс==медь
мысық==кот
мысқыл==насмешка, издевка
мысал==пример
мығым==крепкий, веский, твёрдо, решительно
нық==крепко, прочно
мықты==сильный, мощный, крепкий
мықтау==укреплять
мылтық==ружье, винтовка
мылқау==немой
мынау==это, этот
мынадай==такой, вот такой
ою==прорубать, вырезать
мүсін==фигура
ояту==будить
мүше==часть тела, орган
нүкте==точка
мүлде==совсем, вообще
мүлдем==совершенно
ояну==просыпаться
мүмкін==возможно
мүмкіндік==шанс
мүмкiн==возможный, вероятный, возможно
мін==недостаток, изъян
мінсіз==безупречный, безупречно
міну==садиться верхом, ездить
мінез==характер
мінезді==имеющий характер
міндет==задача, обязанность
міндетті==обязанный, обязательный
міндеттеме==обязательства
оқ==пуля, снаряд
оқтын-оқтын==временами
оқта-текте==от случая к случаю
оқу (оқы, оқиды)==читать, учиться
оқу==чтение
оқушы==ученик
оқулық==учебник
оқшау==обособленный, отдельный, отдельно
оқыс==внезапный, внезапно, нечаянно
оқыту==обучение
оқып шығу==прочитать
оқып болу==прочитать
оқып беру==прочитать кому-то
оқиға==событие, происшествие
оку==читать
ол==он
озу==опережать, обгонять
озғын==передовой, отличный
олқы==слабый, слабость, недостаток
минут==минута
ниет==намерение
озат==передовой, отличный
олай==так
онсыз==без этого
онша==не очень-то
оншалық==не так, не столько
мол==богатый, изобильный, много, обильно
молда==мулла, духовное лицо
молаю==увеличиваться
момын==скромный, тихий, наивный
мойын==шея
мойындау==признавать, осознавать
онда, сонда==тогда
онда==там
ондай==такой
ой==мысль
мерзім==срок
мереке==праздник
мерекелеу==праздновать
несие==кредит
металл==металл
меңіреу==безмолвный, глухонемой
меңгеру==овладевать, управлять
ойшыл==склонный к размышлениям
мешіт==мечеть
ойын==игра, матч
неғұрлым==насколько
ойға түсу==обратить внимание
ойға кету==обратить внимание
мектеп==школа
негіз==основа, основание
негізгі==основной
негізгi==основной
неге==почему
мекен-жай==адрес
мекен==место, местожительства
мекеме==учреждение
мекендеу==проживание
ойлы==умный, задумчивый
мезгіл==время, период
мезгiл==сезон, пора, время, срок
ойлау==думать
ойлану==обдумывать, размышлять
ойланып қалу==задуматься
ойланып айту==говорить обдуманно
мен==я
меншік==собственность
неміс==немецкий, немец
немісше==по-немецки
меніңше==по-моему
мемлекет==государство
мемлекеттік==государственный
немесе==или
ойнату==забавлять, занимать
ойнау==играть
мейрам күнi==праздничный день
мейрам==праздник, торжество
мейірімді==добрый, милосердный
медициналық==медицинский
мейлінше==слишком, чересчур
ойдағыдай==как было задумано
одақ==союз, содружество
одан==из
нарық==рынок
наразы==недовольный
марапат==награда
марапаттау==вознаграждать
мас==пьяный, опьяненный
мата==ткань
маң==окрестность, вокруг
наурыз==март
маусым==сезон, пора, время, июнь
маңызды==важный
маңында==рядом
маңдай==лоб
маххабат==любовь
махаббат==любовь
нашар==плохой, слабый, бедный, плохо
нағыз==истинный, настоящий, самый
мағына==смысл, значение
мағыналы==содержательный, значительный
нақ==точно, как раз
мақұлдау==одобрение
мақсат==цель
мақсатты==целеустремлённый
нақты==конкретный, точный, реальный
мақта==хлопок
мақтау==хвалить
мақтану==хвалиться
мақтаншақ==хвастливый, хвастун
мақтаныш==гордость
мал==скот, богатство
облыс==область
мазмұн==содержание
мазмұндама==изложение
малды==зажиточный, богатый
назар аудару==обратить внимание
назар==внимание
мазасыздық==беспокойство
мазасыздану==беспокоиться, тревожиться
мазалау==беспокоить, тревожить
нан==хлеб
нану==верить
мамыр==май
намыс==честь
наным-сенім==вера
маман==специалист
мамандық==специальность
май==масло
маймыл==обезьяна
майда==мелкий, нежный, вежливый
майдан==фронт, поле битвы
надан==невежественный, невежда
дөрекі==грубый
жөтел==кашель
дөңгелек==круг
жөн==направление, порядок, совет
жөнді==правильный, порядочный
жөнелту==отправлять, отсылать
жөнелу==быть отправленным
жөндеу==ремонтировать, чинить
дәрт==страсть, влечение
дәрі-дәрмек==лекарства, медикаменты
дәрі ішу==принимать лекарство
дәрі==лекарство
дәріхана==аптека
дәрігер==врач
жәрмеңке==ярмарка
дәрмен==сила, мощь
жәрдем==помощь, содействие
жәрдемдесу==помогать, содействовать
дәреже==степень
дәрежелі==имеющий степень
дәстүр==традиция
дәу==великан, гигант
дәуір==эпоха
дәл сол нақ өзі==то же самое
дәл==точно
дәлел==доказательство, довод, аргумент
дәлелдеу==доказывать
дән==зерно
дәм==вкус
дәмсіз==невкусный
және==и
дәмді==вкусный
жәндік==насекомое
жұрт==люди, народ
жұртшылық==общественность
дұрыс==правильный, верный, правильно
жұту==глотать, поглощать
жұқа==тонкий, лёгкий, слабый, тонко
жұлу==вырывать, выщипывать
жұпыны==скромный, бедный
жұлдыз==звезда
жұмсау==посылать
жұмсақ==мягкий
жұмыр==круглый
жұмыртқа==яйцо
жұмыс істеу==работать
жұмыс күнi==рабочий день
жұмыс==работа
жұмысшы==рабочий
жұма==пятница
жұмбақ==загадка
жұбату==утешать, успокаивать
жұбайы==супруг, супруга
ер==мужской, мужчина
ерту==вести за собой
ерте==ранний, рано
ертерек==пораньше
ертең==завтра
ертеңгі==завтрашний, будущий, утренний
ертеңгісін==завтра, утром
ертеңгілік==утренник
ертегі==сказка
ертемен==рано утром
ертеде==прежде, в прошлом
еру (ері, ериді)==следовать, таять
ерік күші==сила воли
ерік==воля, свобода
еріксіз==принудительный, невольный
ерігу (ерік, ерігеді)==бездельничать
ерін==губа
еріну==лениться
еріншек==ленивый, лентяй
еркін==свободно
ерке==шаловливый, избалованный
еркек==мужчина, муж
еркелеу==ласкать, баловать
еркiн==свободный, вольный, свободно
ерлік==подвиг, геройство, храбрость
ермек==развлечение, забава
ересек==взрослый, зрелый
ерекше==особенный, исключительный
ерекшелік==особенность
ерекшелеу==выделять, обособлять
ерен==весьма
ереже==правило
ес==память
есту (есті, естиді)==слышать
есту==слух
естуден қалу==потерять слух
есті==разумный, сознательный
естілу==слышаться, доноситься
есте сақтау==помнить, держать в памяти
естен шығару==забыть
есік==дверь
есім==имя
ескі==старый, давний, ветхий
ескіше==по-старому
еске сақтау==запомнить
еске түсіру==вспоминать
еске алу==вспоминать
ескерту==предупреждать, напоминать
ескеру==учитывать, обратить внимание
есеңгіреу==шок
есеп шығару==решать задачу
есеп==счет
есепті==отчётный, учтённый, считанный
есептеу==считать
есепшіл==расчётливый
ет==мясо
етті==мясной, мясистый
ету==производить действие
еткізу==принуждать к действию
етек==подножие, низ, подол
ең ұзақ==самый дальний
ең==самый
еңселі==высокий, высоко
жуу==мойка, мыть
душар болу==натолкнуться, повстречать
жуырда==совсем недавно
жуық==близкий, скорый
жуыну==умываться
жуындыру==умывать, купать
еңкею==наклон, клониться
жумыс істеу==работать
жуас==тихий, смирный, послушный
жуан==толстый, полный
еңбек ету==трудиться
еңбек==труд
еңбекші==трудящийся
еңбекқор==трудолюбивый
еңбекақы==зарплата
ешқашан==никогда
ешқандай==никакой
ешкі==коза
жыр==былина, песня
жырту==рвать, разрывать, пахать
жыртық==рваный, дырявый
жырлау==воспевать, слагать стихи
жығу==опрокидывать, побеждать
жығылу==сваливаться, повиноваться
жыл сайын==ежегодно
жыл==год
жылтыр==блестящий
жылу==отопление
жылы==теплый, нагревать
жылқы==лошадь
жылжу==двигать
жылдық==годовой
жылжымайтын мүлік==недвижимость
жылдам==быстрый
жылдамдық==скорость
жылау==плакать
жым-жырт==тихо, беззвучно
жынысы==пол
дымқыл==мокрый, влажный
жымию (жыми, жымияды)==улыбаться
жынды==сумасшедший
дыбыс==звук
дыбыстау==подавать голос
дүрсіл==стук, топот
жүру==ходить, идти
жүріс-тұрыс==поведение
жүріс==хотьба, ход, движение
жүріп кету==двинуться, тронуться
жүргізу==водить, вынуждать двигаться
жүргізуші==водитель, ведущий
жүргізілу==заводиться, производиться
жүрек==сердце
дүңкіл==стук, гул
жүк==груз, багаж
жүктеу==нагружать
жүгіру==бег, бегать
дүкен==магазин
жүз==лезвие
жүзу==плавание, плавать
жүзді==имеющий лицо
жүзеге асу==осуществлять, претворять в жизнь
жүзеге асыру==осуществлять, претворять в жизнь
дүлей==свирепый, злой
жүлде==приз
дүние==мир, вселенная
дүниеге келу==родиться
дүниелік==всемирный, космический
дүниежүзілік==всемирный, мировой
дүниеден кету==уйти из жизни
жүдә==очень сильно, совсем
жүйрік==быстрый
дүйсенбi==понедельник
жүйке==нерв
жүйе==система
жүдеу==худощавый, истощённый
жүдеп кету==худеть
діріл==дрожание, дребезжание
жіті==зоркий, энергичный
жіңішке==тонкий, узкий
жіктеу==спрягать
жігіт==джигит, парень, мужчина
жіп==нитка
дін==религия
діни==религиозный
жіберу==посылать, отправлять
жібек==шёлк
егу (ек, егеді)==сажать, сеять
егіс==сев, посев
егіз==парный, схожий
егін==зерно, посев, урожай
екінші==второй
екпін==порыв, пыл, темп
екпінді==порывистый, пылкий, ударный
егер де==если
егде==пожилой
ел==страна
жирен==рыжий
жирену (жиіркену)==брезговать, испытывать отвращение
йлсіз==слабый
елсіз==безлюдный, необитаемый
епті==ловкий, проворный, умелый
ептеп==немного, осторожно
жиып тастау==убрать
жиылу==собираться, столпиться
жиын==сбор, скопление
жию (жи, жияды)==собирать, накоплять
жиі-жиі==очень часто, неоднократно
жиі==частый, густой, часто, густо
жиіркену==отвращение
жинау==убирать, собирать
жинақ==сборник, комплект
жиналу==собираться
жиналыс==собрание
елеу==замечать, обращать внимание
елеусіз==незаметный, незначительный
елеулі==видный, важный, значительный
елемеу==игнорировать, не замечать
ем==лечение
ен==бесконечный, необъятный
жорта==намеренно
жору (жой, жояды)==бежать рысью, рыскать
дорба==сумка
дос==друг
достық==дружба
достасу==подружиться
жоспар==план
жоспарлау==планировать
емтихан==экзамен
жота==хребет
ену==входить, внедряться, быть включённым
жою (жой, жояды)==уничтожать, ликвидировать
доғару==останавливать, прекращать
жоғары шығу==взбираться наверх
жоғары көтерiлу==подниматься наверх
жоғары==высоко
жоғарылау==подниматься
жоғарыда==вверх
жоғарғы==верхний, высший, старший
жоғалту==потеря
жоғалу==теряться, пропадать
емін-еркін==свободно, непринуждённо
жоқ==нет
жоқтау==оплакивать
енгізу==вводить, внедрять
енгізілу==вводиться, вноситься, внедряться
доп==мяч
жол==дорога
жолсерік==гид, путеводитель
жолшыбай==проездом
долы==буйный, бушующий
жолығу (жолық, жолығады)==встречаться, видеться
жолға салу==указывать дорогу
жолдас==товарищ, попутчик,
жолдан қалу==опоздать (на поезд)
жолдама==путёвка
жолаушы==пассажир
жолақ==полосатый
жолақы==оплата за проезд
жомарт==щедрый
домбыра==домбра
домалақ==круглый, шаровидный, шар
енді==теперь
ендік==широта
емдік==лечебный
ендігәрі==в следующий раз
ендігі==нынешний, будущий, предстоящий
емдеу==лечить
емделу==лечиться
жоба==проект
едәуір==достаточно, значительно
жер==земля
дерт==болезнь
жергілікті==местный, коренной
дереу==быстро, моментально
дерек==факт
десу==сговориться
жету==достигать
жетістік==достижение
жеткізу==доставлять, доводить
жеткілікті==достаточно
жетектеу==водить (на поводу)
деу==говорить, сказать
жеу==есть, кушать, жевать
жеңу==побеждать
жеңіс==победа
жеңішке==узкий, сужаться
жеңіл-желпі==слегка
жеңіп алу==завоевать
жеңіл==лёгкий, легко
жеңілтек==лёгкий, легкомысленный, налегке
жеңілу==терпеть поражение, проигрывать
жеңілдік==скидка
жеңге==сноха (жена старшего брата)
деңгей==уровень
жек көру==ненавидеть
жексенбi==воскресенье
жеке-жеке==отдельно, порознь
жеке меншік==личный, приватный
жеке==частный
жекелеу==отделять
жел==ветер
желсіз==безветренный
желтоқсан==декабрь
желу==бежать трусцой
желім==клей
желкен==парус
желді==ветренный
дем алу==дышать
жем==зерно, корм
дем==дыхание
денсаулық==здоровье
жеміс-жидек==фрукт
жеміс==ягода
жемісті==плодотворный
дене==тело
демеу жасау==поддерживать
демеу==поддержка
денелі==рослый, крупный
жемдеу==кормить скот
демалу==отдыхать
демалыс күнi==выходной день
демалыс==отдых
ежелгi==древний, давний
ежелден==с давних пор
еден==пол
жедел==срочно
жар==оповещение, клич
жарты сағат==полчаса
жартылай==наполовину
жару==колоть, разрывать
жарыс==соревнование
жарысу==соревноваться
жарық==свет
жарықтандыру==освещать
жарылу==раскалываться, разрываться
жарылыс жасау==взврывать
жарылыс==взрыв
жарым==полоумный, половина
дарынды==способный, талантливый
жарқырау==сиять, сверкать
жарқылдау==сверкать, вспыхивать
жарқын==светлый, яркий, радушный
жарлы==бедный, бедняк
жарлылық==бедность
жариялау==публиковать, обнародовать
жарнама==реклама
жара==рана, язва
жарасу==соответствовать, мириться
жарату==одобрять, употреблять
жаратылыс==природа, натура
жарау==годиться, быть годным
жарақ==оружие, вооружение
жарақат==ранение, травма
жаралы==раненый
жас==молодой
жастық==подушка
дастан==эпос, поэма
жасыру==прятать, скрывать
жасырын==тайный, секретный, скрытый
жасыл==зелёный
жасау==делать
жасалу==делаться, изготовляться
жасанды==искусственный, поддельный, ложный
жат==чужой, чуждый
жаттығу==тренировка
жаттау==заучивать
жаттап алу==выучить наизусть
жату==лежать
жатық==пологий, складный, складно
жатқа оқу==учить наизусть
жатақ==логово, берлога
жатақхана==общежитие
дау==спор, иск
жау==враг
жаурау==мёрзнуть, зябнуть
даусыз==бесспорный
жауу==идти, выпадать (осадки)
дауыс беру==голосовать, отдавать свой голос
дауыс==голос
дауыстап==громко, вслух
жауып тастау==закрыть (дело), посадить (в тюрьму)
жауыз==злобный, зловредный
жаңғыру==обновляться, меняться
жаңғақ==орех
даңқты==прославленный
даулы==спорный
дауласу==спорить
жаңа==новый
жаңаша==по-новому
жаңбыр==дождь
жаңбырлы==дождливый
жаңағы==упомянутый, тот самый
жауап беру==отвечать
жауап==ответ
жауапты==ответственный
жаңалық ашу==открытие
жаңалық==новость
жауапкершілік==ответственность
жаңада==недавно
жаңадан==снова
жаю (жай, жаяды)==расстилать, накрывать
даяр==готовый
даярлау==готовить, подготавливать
жаяу жүру==идти пешком
жаяу==пеший, пешком
жағу (жақ, жағады)==зажигать
жағымсыз==неприятный, противный
жағымды==приятный, положительный
дағдылы==обычный, привычный
дағдарыс==кризис
жағдай==случай, событие
жаға==воротник
жағалау==идти берегом, идти вдоль
жақ==сторона
дақ==пятно, ссадина, отпечаток
жақсы көру==любить
жақсы==хорошо
жақсылық==доброта, добродетель
жақсарту==улучшать
жақсару==улучшаться
жақтыру==одобрять
жақын арада==скоро
жақын==близкий, недавний, родной
жақында==недавно, скоро, рядом
жақындау==приближаться
жаз==лето
жапсыру==приклеивать, пришивать
жапсырма==заплатка
жазу==написание, вылечивание
жазушы==писатель
жапырақ==лист
жазысу==переписываться
жалығу (жалық, жалығады)==скучать, утомляться
жазық==плоский, ровный, равнина
жазықсыз==невинный, чистый
жазықты==виновный, провинившийся
жазып алу==списать
жазып болу==написать
жазып беру==написать
жазылу==выздоравливать, записываться
жалын==пламя
жалыну==умолять
жалынды==горящий, пылающий
жазғы==летный
жалғыз==одинокий
жалғыздық==одиночество
жалғас==примыкающий, последующий
жалғастыру==продолжать, соединять
жалғасу==продолжаться
жалғау==соединять, присоединять
жалған==ложный, фиктивный
жалқау==ленивый, бездельник
жалқаулық==лень
жалпы==общий
жалпақ==плоский, широкий
жаппай==сплошь, поголовно
жапон==японский, японец
дала==степь, двор
жаза==наказание, кара
жалау==флаг
жалаң==голый, без ничего
жалаңаш==голый, нагой, пустой
жазалау==наказание
жападан-жалғыз==одиноко
жазба==письменный
жазбаша==письменно
жан-жақты==всесторонний, подробный
жан==душа, дух
жансыз==безжизненный, неодушевленный
даму (дамы, дамиды)==развиваться, расти
даму==развитие
жану==зажигаться, гореть
жануар==животное
дамыту==развивать, повышать
данышпан==гениальный
жанды==живой, одушевленный
жанжал==ссора, скандал
дана==мудрый, мудрец
жанар==блеск, вид
жаман==плохой
жамандық==зло
жай==простой, обыкновенный, тихий
жайсыз жағдай==неприятность
жайсыз==неудобный, неудачный
жайылу==простираться, раскидываться
дайын==готовый, готов
дайындық==подготовка
дайындау==готовить, подготавливать
дайындалу==готовиться
жайғасу==располагаться, устраиваться
жайлы==уютный, удобный, спокойный
жайлылық==комфорт
жайлау==обитать, располагаться
жайнау==блестеть, сверкать
жайдақ==плоский, простой, неглубокий
жабу (жап, жабады)==закрывать
жабысу==липнуть, склеиваться
жабысқақ==липкий
жабық==закрытый
дабыл==сигнал
жабылу==закрываться
жабдық==средство
жабайы==дикий
бөтелке==бутылка
бөтен==посторонний, чужой, другой
бөгеу==задерживать, препятствовать
бөгелу==задерживаться, останавливаться
бөгде==посторонний, чужой
бөлу==распределение, отделять
бөлшек==частица
бөлісу==делиться друг с другом
бөлік==часть
бөлігі==часть
бөлім==часть, отдел
бөліну==делиться, быть делимым
бөлімше==подразделение
бөлме==комната
бөлек==отдельный
бөлекше==особенно
бәрібір==как угодно, всё равно
бәтеңке==ботинок
бәліш==пирог
бәле==беда, несчастье
бәлеге қалу==попасть в беду
бәйге==байга, скачка
бәйбіше==супруга, сударыня
бұру==поворот, поворачивать
бұрыш==угол
бұрылу==поворачиваться, завернуть
бұрын==раньше
бұрынғы==прежний, предыдущий
бұрынғыша==по-прежнему
бұрнағы күнi==позавчера
бұқтыру==глушить, тушить, заваривать
бұлт==облако
бұзу==разрушение
бұлшық ет==мускул
бұзық==хулиганистый
бұзылу==портиться, повреждаться
бұзылған==испорченный, повреждённый
бұлдыр==неотчетливый, нерезкий, туманный
бұлай==так
бұнда==здесь, сюда
бұндай==такой
бұйрық==приказ
бұйра==кудрявый
бұйыру==велеть, приказывать
бұйым==изделие
ар==совесть, честь
арсыз==наглый, бессовестный
арт==зад, задняя сторона
арттыру==повышать, увеличивать
арттан==сзади
арту==возлагать, грузить, поручать
артық==лучший, излишний, лучше, излишек
артықшылық==преимущество
артынша==вслед, затем
артында==сзади
артқы==последний, задний
артқа==назад
аршу (аршы, аршиды)==чистить (от кожуры)
ары==дальше, прочь
арыстан==лев
арық==худой
арықтау==худеть
арыз==жалоба, прошение
арылу==избавляться, расходиться
арғы==далёкий, противоположный
арқылы==через
арқа сүйеу==опираться на поддержку
арқа==спина
арқан==канат, веревка, трос
арка==арка
арзан==дешёвый
арнау==посвящать, предназначать
арнаулы==посвящённый, специальный
арналу==посвящаться, предназначаться
арман ету==мечтать
арман==мечта
армандау==мечтать
арнайы==специальный, специально
ардақты==уважаемый, дорогой, милый
ара-тұра==временами
ара==пчела
арасында==между
арал==остров
араз==находящийся в соре
аралсқан==перемешанный
аралас==смешанный
араластыру==смешивать
араласу==смешиваться, общаться
аралау==ходить, бродить, распиливать
арам==нечистый, нечестный
арамшөп==сорняк
арайы==специальный
арба==арба, повозка, телега
ас әзірлеу==готовить
ас мәзірі==меню
ас==еда, пища
асты==нижняя сторона, низ
астыртын==тайно
астында==под
астан қалу==потерять аппетит
астам==более
астана==столица
асу==вешать, варить, превосходить
асхана==столовая
асыру==претворять, воплощать
асырау==содержать, кормить
асығу (асық, асығады)==спешить, торопиться
асығыс==поспешно, срочно
асығыста==в спешке
асыл тас==драгоценный камень
асыл==драгоценный, благородный
асқар==высочайший, неприступный
асқақ==высочайший, высокомерный
аспап==инструмент
аспан==небо
аса==сверх
асау==дикий, строптивый
ат==имя, название, конь
атты==именуемый, конный
аттау==шагать
аттану==отправляться в путь
ату==стрелять, взмывать, ударять
атылу==быть кинутым, выпрыгнуть
атқару==исполнять, выполнять
ата==дед, дедушка, предок
атау==называть, именовать
атаулы==именной, именованный
атақ==слава, звание
атақты==знаменитый, знатный, прославленный
атап өту==отпраздновать, отметить
аталу==называться, упоминаться
атану==именоваться, получить звание
аң аулау==охота
аң==животное, зверь
ауру==больной, болезнь
аурухана==больница
бурыл==седой
ауу==опрокидываться, сваливаться
ауыр==трудный, тяжелый
ауыру==болеть
ауырып қалу==заболеть
ауыстыру==менять
ауысу==сменяться, перемещаться
аңықтау==выяснять, уточнять
ауыз==рот
аңыз==легенда, миф
ауыл==аул
ауызша==устно
буын==сустав, звено, слог
аңғару==догадаться, уловить суть
ауқымды==широкий
аңқау==наивный, доверчивый, простак
аула==двор
аулау==ловить, охотиться
аулақ==прочь
аңду==выслеживать, подкарауливать
аудару==переводить, опрокидывать
аударма==перевод
аңдау==вникать, понимать, примечать
аудан==район, местность
аудандық==районный
ауа-райы==погода
ауа райы==погода
ауа жұту==дышать
ауа==воздух, проветривать
аш-арық==истощённый
аш==голодный
аштық==голод
ашу (аш, ашады)==открывать, выявлять
ашу (ашы, ашиды)==бродить, закисать
ашу==открытый
ашушаң==злобный, вспыльчивый
ашулы==сердитый
ашулану==злиться, сердиться
ашық түс==яркий
ашық==открытый
ашылу==открываться, быть открытым
ашаң==худощавый (лицом)
ащы==острый, едкий, горький
былтыр==в прошлом году
былтырғы==прошлогодний
былай==так
бүрсігүні==послезавтра
бүрсiгүнi==послезавтра
бүтін==целый, единый, исправный
аяу==жалеть, щадить
аяусыз==безжалостный
аяулы==дорогой, милый, ценный
аяқ киім==обувь
аяқ==нога
аяқтау==кончать, заканчивать
аяқталу==заканчиваться
аяқасты==внезапный
бүктеу==свёртывать
бүгу (бук, бүгеді)==гнуть, загибать
бүгін==сегодня
бүгінгі==сегодняшний, нынешний
бүгінде==нынче
бүгiн==сегодня
аяз==мороз
бүлдіру==коверкать, портить, разрушать
аялдама==остановка
бүйту==делать так
ағу (ақ, ағады)==течь, протекать
ағызу==пускать, сплавлять, нестись
ағылшын==английский, англичанин
аға==брат
ағаш==дерево
ағайн==сородичи, родня
бір-бірден==по одному
бір күні==однажды
бір жерде==где-нибудь
бірсыпыра==изрядно, довольно
біртіндеп==один за другим, постепенно
бірталай==значительно
бірыңғай==единый, одинаковый
бірігу==соединяться, объединяться
бірінші==первый
бірқатар==несколько, ряд
бірге==вместе, с
бірлік==единство
бірлестік==объединение, товарищество
бірлесу==присоединяться
бірен-саран==редко
біржола==заодно, всё сразу
біржолата==совсем, насовсем
бірде==однажды
бірден==сразу
бірдей==идентичный, одинаковый
бірақ==а, но
біраз==немного
біту==кончаться, завершаться
бітіру==заканчивать
білу==знать
білім алу==получать образование
білім==образование
білімсіз==необразованный, невежда
біліну==выявляться, обнаруживаться,
білімді==образованный, сведущий
білгір==знающий, сведущий
білдіру==обозначать, сообщать
ақ көңіл==добродушный
ақ==белый, седой, чистый, искренний
ақсақ==хромой
ақсақал==старейшина, уважаемое лицо
ақтау==белить, оправдывать
ақшыл көк==лиловый
ақшыл==беловатый
ақша==деньги
ақы==плата
ақыру==реветь, свирепствовать, орать
ақыры==наконец, наконец-то
ақырын==потихоньку, мирно, тихо
ақырында==в конце концов
ақырғы==заключительный
ақыл салу==советовать
ақыл==ум, интеллект
ақылы==платный, оплачиваемый
ақылға келу==образумиться
ақылды==мудрый
ақылдасу==советоваться
ақын==акын, поэт
ақындық==поэтический дар
ақымақ==глупый
аққұман==чайник
аққұба==светлокожий
аққала==снеговик, снежная крепость
ақпан==февраль
ак==белый
би==танец
аз==малый, небольшой
алтын==золото
апта (жұма)==неделя
апта==неделя
азу==истощаться, вырождаться
алу==брать, взять
алуан==различный, разный
бишара==беспомощный
алыс==дальний, отдаленный
алыстан==издалека
алысу==бороться, обмениваться
алып сату==перепродать
алып тастау==отбрасывать, уволить
алып шығу==вынести
алып қалу==отобрать, оставить себе
алып кету==увести, забрать, унести
алып келу==привести, доставить
алып жүру==носить с собой
алып беру==подать, передать, достать
алып бару==отвезти, отнести
алып==мощный, сильный
биыл==в этом году
биылғы==нынешний, этого года
азын-аулақ==незначительно, чуть-чуть
алыну==быть взятым, взиматься
алғыр==хваткий, цепкий, находчивый
алғыс білдіру==выражать благодарность
алғыс алу==получать благодарность
алғыс айту==благодарить
алғыс==благодарность
алғызу==брать
алға==вперёд
алғаш==впервые
алғашқы==первый, начальный, прежний
азғантай==чуточку
азғана==чуть, немного
биік==высокий, высота
алқызыл==алый
билік==сила, власть
билеу==танцевать
аппарат==аппарат
аппақ==белоснежный, белый-пребелый
алма==яблоко
алмастыру==заменить, обменять
алды==перед, передняя часть
алдыру==заказывать, забирать, стричь
алдыңғы күнi==позавчера
алдыңғы жыл==позапрошлый год
алдыңғы==передний, передовой
алдыңгүні==позавчера
алдымен==прежде всего, сперва
алдында==перед
алдынан шығу==выходить навстречу, встречать
апельсин==апельсин
алда==впереди
алдау==обманывать
алдағы==будущий, предстоящий
алдап соғу==обмануть
аздап==понемногу
алдан==спереди
алдану==обманываться, забавляться, возиться
апа==старшая сестра
ала==пёстрый, неодинаковый
апару==уносить
апарып беру==отнести
аласа==низкий
апат==крушение, трагедия, бедствие
азат==вольный, свободный
алау==костёр
алаң==площадь
азаю (азай, азаяды)==уменьшаться, убывать
азамат==гражданин
бор==мел
борыш==долг
боран==буран, буря
бос==свободный, пустой
бостандық==свобода
босқа==зря
босату==освобождать
босау==освобождаться
ант==клятва, присяга
антұрған==проклятый
ботқа==каша
анық==ясный, достоверный
анықтама==справка, определение
бояу==красить, окрашивать
бояну==краситься
боз==светлый, светло-серый
болу==быть
болысу==договориться, заступаться
болып шығу==оказаться
болымсыз==незначительный, едва заметный
болмаса==или
болжау==предвидеть, прогнозировать
болжалды==предположительный, намеченный
болжам==предположение
болат==сталь
болашақ==будущее
бой==рост
бойлы==рослый
бойдақ==холостой, неженатый, незамужняя
анда-санда==иногда, временами
анда==туда, там
ана==мать
анағұрлым==намного, гораздо
амал==действие, поступок, выход
амалсыз==безвыходный, вынужденный
амалсыздан==поневоле, безысходно
аналық==материнский, женский
аман-есен==благополучный
аман==здоровый, невредимый, невредимо
амандасу==здороваться
анада==тогда, в то время
ай==луна, месяц
бертін==сюда, ближе
беру==давать
айрықша==в особенности, особо
айрылу==лишиться, расстаться
бері==ближе, сюда
берік==крепкий, прочный, твёрдый
беріп кету==оставить, отдать
берілу==быть отданным, сдаваться
бергі==ближний, близкий
береке==благо, единство, изобилие
бет==страница, лицо
беттеу==взять направление, ехать
айту==говорить
айтуынша==по словам
айтыс==айтыс, состязание поэтов
айтысу==дискутировать, спорить
айтып салу==высказать, ляпнуть
айтып шығу==пересказать
айтып жіберу==передать, подсказать
айтып беру==рассказывать, излагать
айтылу==быть сказанным
беті==сторона
айтқызу==заставить говорить
бетке-бет==лицом к лицу
бетпе-бет==лицом к лицу
бетер==более, хуже
беталыс==направление
айыру==отделять, разлучать, лишать
айырылу==лишаться, терять
айырма==разница
айырмашылық==различие
ажырасу==расходиться, разводиться
айырбастау==обмен
айығу (айық, айығады)==выздоравливать, поправляться, проясняться
айып==вина, проступок, штраф
айыпты==виноватый, повинный
айыппұл==штраф
айғай==крик
айғайлау==громко кричать
айқын==очевидный, явный, чёткий
айқындау==выяснить, уточнить
айқалау==обнимать, ласкать
айқайлау==громко кричать, шуметь
бек==крепко, сильно
беку (бекі, бекиді)==укрепляться
бекіту==утверждение
бекіну==укрепиться, держать оборону
бекініс==укрепление
бекер==зря, напрасно
бекерге==попусту, понапрасну
бекем==крепкий, прочный, крепко
бел==поясница, опора
белсенді==активный
айлы==лунный
айлық (жалақы)==зарплата
белгі==знак, признак
белгісіз==неизвестный, неопределенный
белгілі==знаменитый, известный
белгілеу==метить, обозначать
безендіру==украшать
айлалы==ловкий, изворотливый
айну (айны, айниды)==отказываться
айна==зеркало
айналу==вращаться, крутиться
айналысу==заниматься, увлекаться
айналдыру==вращать, крутить
айнала==среда, окружение
айнадай==чистый, ясный, зеркально, ясно
бейсенбi==четверг
бейтаныс==незнакомый, незнакомец
бейім==склонный, способный
бейне==облик, образ
бейнелі==образный, подобный
бейнелеу==изображать
бейнелену==изображаться
бедел==авторитет
айдау==водить, гнать
бейбіт==мирный, мирно
айдай==луноподобный
ажар==вид, взгляд
ажарлы==миловидный, симпатичный
адасу==плутать, заблуждаться
адал==честный, верный, искренний, честно
адам==человек
адамша==по-человечески
бару==идти, ехать
барыс==направление
барып шығу==заглянуть, зайти мимоходом
барып келу==сходить, съездить
барынша==вовсю, максимально
барлық==все, весь
барабар==адекватный, одинаковый
бас тарту==отказываться
бас киім==шляпа
бас==голова
бассейн==бассейн
басты==главный, ведущий
бастыру==давить, молотить, печатать
бастық==начальник
баста==в начале, поначалу
бастау==начинать
бастауыш==начальный, первичный
басталу==начинаться
бастан-аяқ==полностью, целиком
бастама==идея
басу==давить, нажимать
басшы==главный
басшылық==руководство
басып шығару==печатать
басылу==замолкать, прекратиться, издаваться
басым==подавляющий, превосходящий
басында==сначала, прежде
басқа==другой
басқару==управление
басқарма==управление
басқаша==по-другому, иначе
баспалдақ==ступенька, лестница
бату==тонуть, погружаться
батыр==отважный, смелый
батыру==топить, погружать
батырлық==героический, героизм
батырма==кнопка
батыс==запад
батыл==смелый, бесстрашный, смело
батылдық==храбрость
автобус==автобус
бата==благословение
бауыр==печень, брат
бауырмал==добрый, отзывчивый
баулық==шнур
абырой==честь, совесть, репутация
абыройлы==авторитетный
баяу==медленный
баяғы==прежний, давний, прошлый
баяғыда==давно, прежде, раньше
баяндау==сообщать, докладывать
баяндама==доклад
бағу (бақ, бағады)==пасти, присматривать
бағыт алу==взять направление, направиться
бағыт==направление, курс, маршрут
бағыттау==направлять
бағыну==повиноваться, подчиняться
бағдарлама==передача
баға==цена
бағалы==дорогой
бағалау==ценить, оценивать
бағана==некоторое время назад
бағанағы==недавний
бағанадан==с тех пор
бақ==сад, счастье
бақша==сад
бақыру==кричать, вопить
бақыт==счастье
бақытсыз==несчастный, неудачливый, неудачник
бақытты==счастливый
бақылау==контроль
вагон==вагон
бал==медь
балық==рыба
балғын==свежий, сочный, юный
балға==молоток
балмұздақ==мороженое
бала бағу==нянчить
бала==мальчик
балаша==по-детски
абзал==благородный, достойный
балабақша==детский сад
банк==банк
ванна==ванна
бай==богатый, зажиточный, богач
байсалды==уравновешенный, спокойный
байтақ==обширный, широкий, необъятный
байғұс==бедный, несчастный, бедняга
байқау==наблюдать, следить
байқалу==обнаруживаться, выявляться
байқамай қалу==не уследить
байлық==богатство, состояние, благо
байлау==завязывать, связывать, перевязка
байлаулы==привязанный, завязанный
байланыс==связь
байланысты==связанный, относящийся
байланыстыру==связывать, устанавливать связь
байланысу==связываться друг с другом
абай==осторожный, осмотрительный
абайсызда==случайно, неожиданно